30 30
TTTTTTTTTTTTTTTTTTTTTTTTTTTTTT
T+.T._*~+.x.x*R....._..x...*xT
Tx.xx..*.~....x.x_......*._~TT
T.+.x.+R..T.R++_R....+._.R...T
TT..._RRx...xT..+x.R....T+...T
T....R*.~......*_..TRx~...*.RT
T...._.~x.+...T..+*.R....*...T
T...~R..~+.+_.R.~...._R.~....T
Tx.._.R**.x.__+.TR+x.T..*_T.+T
T...R__._.+*.T.~...*.x....++.T
T.......+.~..__~.x~.....xR._.T
T.Rx..+x_.*...Tx........._+..T
T.......+*...~_.._..x....T..+T
T...*.~..R~.R.RT..*x.x..._.*.T
TT+..+**Rx...*......xR.TR...TT
T...R.x...R.x.R..._.~.R.*x._.T
T.*..*....x....~R..T~.._...T.T
T._...+~...x*...T.~.T..~~..~*T
T..........+._._*.*...x.__...T
TRxx.*RT~*+x~..._....__.~...xT
Tx..~.R.R._.........R.x*.....T
T.....T.x...~..x.xx.R.R...+x.T
T.x.._..._~~*.__.Rx~.xR+.T.RTT
T.**_x.R._~...*+L_..x_....._.T
T~.+...T+.xTT...~...Tx....._.T
Tx...T...T*_*..T.T*...*.R_.~RT
T.*._.+_....*..T.*..T..R..Tx.T
T._+.~.x..~..xR_xRT.~~xx~....T
TR*.R....x.+.~.TR.T.x.......TT
TTTTTTTTTTTTTTTTTTTTTTTTTTTTTT