10 19
TTTTTTTTTTTTTTTTTTT
T....+R..T+....x..T
T~...x*._..R......T
TT~_.*...+.....~.RT
T.*.._.....x..*L..T
T.......R....R*...T
T..........._.*T.RT
TR._.~..R.x*...RR.T
TR....~T.T_.......T
TTTTTTTTTTTTTTTTTTT