10 20
TTTTTTTTTTTTTTTTTTTT
T.~..........TR.R.RT
T.....*......_...R.T
T.T...*L.x.....T.*.T
T..~....*+...._....T
TR........._.T.....T
T.......x..+.....TxT
T..R+.*._.+........T
T......*+.R....+...T
TTTTTTTTTTTTTTTTTTTT