13 20
TTTTTTTTTTTTTTTTTTTT
TR.R~....T.........T
T..~~.....~.....*..T
T..*.........~...R~T
T.R~.....~R...~.~.~T
T.R~RR...R...T..~~.T
TR.~..+.R~....~..R.T
TR.T.T~R.x.T....~T.T
T.~~R...R~...~L~~.~T
T..T..RT..~...~.*.TT
T..R...xR*~T.._~~.RT
T.~.~...R.~+T~.T~..T
TTTTTTTTTTTTTTTTTTTT