11 21
TTTTTTTTTTTTTTTTTTTTT
T..~...*........~...T
T...+R..R...........T
T.......R.....R.....T
T.....R..R.R..R...R.T
TR..................T
T........._..*......T
TR..Rx~...R*....__~.T
T..*Rx.....+TL......T
T...T.R........*...RT
TTTTTTTTTTTTTTTTTTTTT