20 10
TTTTTTTTTT
TR.....T.T
T.++.*...T
T..TTT.~.T
T_TT.....T
T+....T.TT
T~~.xxT.*T
T.....+..T
T.....R..T
T.R_xT...T
T...*....T
TT..T.T..T
T.._.R~.+T
Tx....T_.T
T.......TT
TR...+.R.T
T..RR....T
T..R..x..T
T+~L...R.T
TTTTTTTTTT