15 22
TTTTTTTTTTTTTTTTTTTTTT
T.....*.+.TR....~.T..T
T....T.T+..*T++TT*T..T
T..x.+T.T..Rx...TT..TT
T.RT.......T.....+R~TT
TT.x._+..T...~T..T...T
T+.T.~x.....R....R.RRT
T...T..R.R_R....T....T
T......R+T...T....~..T
T.......+.__......_..T
Tx.~~L...T..*........T
T..~......T.T.T_.T...T
T...T.RT...T....TR...T
T..T.R...R...RTR...TRT
TTTTTTTTTTTTTTTTTTTTTT