13 20
TTTTTTTTTTTTTTTTTTTT
T.x...R_....T.R..++T
T+..T..R..+.T......T
TTT....TRR..~.._...T
T+...x......RTRR...T
TR.._...L...x....+.T
TRxR..R.R...+.*..*.T
T*.T..*T+.....R....T
TT...*........+....T
T+.*~~.T...+.R....TT
T.x..R............*T
T*T.R*.....T...T...T
TTTTTTTTTTTTTTTTTTTT