20 30
TTTTTTTTTTTTTTTTTTTTTTTTTTTTTT
T..._....._.....T...x.......TT
T.._TTT.Rx..+~.T_.R.++.x+TT..T
T.*T..~T.....~..T.TT...x...T+T
T~.+.*.........T.....~.T...T.T
TT.R...*.+.TT....~T...*R_.xTxT
TLT._R.T._._....R*TR.....TT.~T
T..R._R.*..T.T.......T_..R+T.T
T....T.._~....~_~...~T.....R.T
T.T.....R.T.xRT.R*RT.+x......T
TR..T..R.*+.R.T.......TRT....T
T.T_..R...R....*T..T..T..+..TT
T~...T_.......T.R............T
T.R*xR_....T.x...*.xT~RT.R._.T
T+..*..x._T...*~.............T
T..RxT~....~.+TT+...T.R....TxT
T.RT..._...T_.......+.._.....T
TR.T*...*.T...RT.+.+x........T
T....._........_.........T...T
TTTTTTTTTTTTTTTTTTTTTTTTTTTTTT