10 20
TTTTTTTTTTTTTTTTTTTT
T..................T
T..................T
T.....~....+.+.....T
T.....~......+.....T
T.....~............T
T..........L.......T
T..................T
TTTTTTTTTTTTTTTTTTTT