30 30
TTTTTTTTTTTTTTTTTTTTTTTTTTTTTT
T_..*._.R...+Rx..+**.._x+.x..T
T*xx_...*......~_R.~.~~.+...xT
T.......~T.+..._.~..*+T+*.x..T
TT.+*...Rx_R......*.x+_._.T..T
T._~~*R+.Tx...*...~.T...x....T
TR~.T*........_R_x+........_.T
Tx..xTx.+....~...*.~.+..+..+.T
T_.....+R~_.T.xR.*.~RR._..+.+T
T...~..L.._..~R.+.......R*._.T
T*~R......T..T..Tx...*.~...+.T
T+.x.+..Rx...*._RR.*....T..T_T
TR.+..*+......R~..R...~R._.x+T
T.~...~x+........*...~..**~+*T
T..xRT.T_+.*..x._.x..+.....R.T
T..*...T+..~x~+R.x.....T._...T
T.*T...x*....T.*x.....~...*R.T
TR.....~*...x...._**.R_~x....T
T.x..~.~T~+..x...x..~....._T.T
T*R...T.....*....T...*.._R._xT
T......x..~R._.._*R._..*..R..T
T.*.......Tx.R...~.*..x.+...xT
T++....+_..R.~.....+_...T~+.~T
T.....*.......T.+T~.R*.T*....T
T.TR..*....x*...T.x_.T.+...~.T
T...x*T+....~+.~....~.*.~~x.RT
T..x*..+~_.~....R.._.~..~.*.~T
T*T...+RT+*.R..R*..+.xT.x+.x.T
T..*~.~...R..~~..x._.......R.T
TTTTTTTTTTTTTTTTTTTTTTTTTTTTTT