30 30
TTTTTTTTTTTTTTTTTTTTTTTTTTTTTT
T._T........*..._TT..R.T...R.T
Tx.T...+.T.T......L..........T
T.x....T....*.......+......TTT
T.....................~.._...T
T..........+T..T.T.T.~...T.R.T
T....T............R..........T
T.................T.....TT...T
TT....R...~*.....TR.........RT
T...x.T................._R*..T
T..T.........x....T.T..T...+.T
T.T~.....TT...+..TT..._.R.R..T
T.+.R...................T.T.TT
T.T.R........+........R......T
T........T..T.....T....R.....T
T..T..T......R......T.T....~.T
T....T....R.R.........T......T
T..........T.._...R_..+......T
T.......*...x......._..x.*..~T
T..T.x..R....R._.Tx....TR....T
T.R..~.R*.TT....T....+....~xTT
T....T...............T.....~.T
T........x._RT..T...._.......T
T...................*.......TT
TT._.............T*...+R....RT
T....R.....~...T.......x.....T
T...T...R....T.....+..R......T
T......T....T.............T..T
T+R......xR._x.._.....RT..x..T
TTTTTTTTTTTTTTTTTTTTTTTTTTTTTT