30 30
TTTTTTTTTTTTTTTTTTTTTTTTTTTTTT
T~...xT*+x.*+..~~....R..+T._xT
T.....+T.TT..T....._*...+..._T
TxR.RT..x...._.T~.~.._.x+Rx_RT
T+~.xT.RRR.+._+x.._.**.x...*.T
T.R..+~.x._..T.~...~.R~*...~*T
T.._.._...*.T.~RT.T...*....~.T
T++.....RRRT._..._._*TT..x...T
T.~*~_..xx+......~.*+.._R..+.T
T.x.*+_..*~~Rx.TT.T....+x..R+T
T...x..TT.xR.._TT~.._T._..R*TT
T_.T_....++T.~.+T.x..+.R.x..RT
T....~.~R_.*.R.._+R*.._...T+~T
T....T.~......._.+**_.....~.+T
T_*x..R+.+xxx....*x.*....R.._T
Tx.R.~.R.+..~x.x...*_xT+...x.T
TR....._+.+.....x...~*.......T
T....+....+.....x.~*.**.~..~.T
T.x...*.TT..~.T........+.T*..T
T...x....+T.T..*.~.R..x*~.T..T
Txx..~T.+..T..xR+.+........x+T
TT_.....L..R.*.~*..TR*_..TT+.T
T..T.T.*...x.R........x_.....T
T.*Tx_.T...*..+..~.Txx.T*+T..T
T..T...x...~.x.._T_~.+~_..T._T
T._..+..T...+~_x*.RR~T..+.*~.T
T..~.~.+.........xT+R.RR.+.*RT
T....x~xT.*x...*.R.T.++....x.T
Tx.+T.T..x..._.+..x...._.....T
TTTTTTTTTTTTTTTTTTTTTTTTTTTTTT