30 30
TTTTTTTTTTTTTTTTTTTTTTTTTTTTTT
TR~....x+..+.T......~_....x..T
T._..+RT*..T...R...T*__R.._~_T
T..x+T.x..*.x~~.~+.R..*~._...T
T~..x_.+.RTR...*..*+...R~....T
T............._.*._..*RR.....T
T....TRTT...T.._...~...__.~~.T
TR.....*.....+*..._R+..+...T~T
T._.*_+_.._.x~.L.._~xR...._R.T
T.._~......**.T*TRR._.*R~_+.xT
T*...~...T.x+.x.+..T....._RR+T
T..Rx.T.R+...x+*xT..+.+..R.x.T
T...*.~...~*..*+..*_...x...~~T
T...T.~~x.x..+.R.*..x.._~....T
T.~.R..RR..++...~R.+..**x~Rx.T
T.T..~...x....~..R........_.TT
T~~......+.~.+.......x*.*.x..T
TR....~.......TR.x~..._...T.TT
T._.*T..+....*...+.*xRR.T*.~.T
T...*....R.xx.+x.+_*T.RR.x~~TT
TTT*.....~+R....x........xx..T
TT.x...*...x_..+.R.R.x....*..T
T._...~.*...xT.._....R.......T
T....x.T..T_....+...R........T
T..+....._.~xR...R.Rx*x....x.T
TT.*.._~*.....+._..x...~...RRT
T.T+*.R.~....~.._.x....T.....T
T.........+.*...T**+...T.x+..T
T..~+..x.xR*_+~.....+....+...T
TTTTTTTTTTTTTTTTTTTTTTTTTTTTTT