30 30
TTTTTTTTTTTTTTTTTTTTTTTTTTTTTT
T....*x*.....~*....RxR*...*.RT
T*.......~..._...T.x.x*~.x_..T
T.~..~*~._...~.....R...x...R*T
T........*_.R*.x.R~_...*+*_..T
T.+.T.+..._._...*RT..xR.+.x+.T
TTT._.R.R_.+x~...+.~+~_*.T.._T
T.+x.T......._....T.T......+.T
T.+T.~*....Rx*~*.....RR....T.T
T....R.T.*..T...+R.*....*...RT
T.......~...*....x~Rx...+.RT.T
T..+.TT.......*+*.**...*~....T
T~*_x.~.+~.*+..*x.x....._R_*~T
T+_*x..**....x~.xT+.*.T+~.x.RT
T....~.........Tx..xRT.+.T..+T
T.**R....R_R..Rx......~x.x._*T
T_*.R...x.**...RT.......x._~_T
T.~xT..._.~T*..*_+_.*__.R~*..T
TR........x...~...RT*........T
T.*_.*RR..R.*.+.~.....x__*..xT
TR.....*+*.*....R.RR..*RL.R..T
T..+.x.~R._....R.~._...*.....T
T..._..x.R*.._~.._......RxT..T
T......T..~..T_.*RR.+__.._..TT
T..+...~....*...~......xx..._T
T..~.T.x.R.+~T.~T~.x_Tx..~...T
T.+.x..TR...T.xT._R.x..~_...+T
T.x...*...RTT**.++TR..*R.+...T
T.~*~_....~.TTR.T....x_*T~..TT
TTTTTTTTTTTTTTTTTTTTTTTTTTTTTT