30 30
TTTTTTTTTTTTTTTTTTTTTTTTTTTTTT
Tx+._x.Tx_+...*..*..T.+....T+T
T..*..+..R....~...+.~x..*....T
T.+....~..*T~+.x_....*....+.~T
T.x.R..R.RR........x.....*~..T
T*+..*T_*T_.~~_*R.x.~...+_..xT
T_..............*~.*.~.*~.._.T
T+.+.~.~.xR.....RR..__..+x...T
T......*~.*~.*.~~._..*..x.++.T
T..R....T...x.R...._*....x+..T
T_...+~.~+x....+...*.~...+.x.T
TT...*.~.+.+~.~_..x......+x..T
T....R....~.RLx_T..._.T.~....T
T.T.~_R........_..T*..RRx.x..T
T_~~x.*T*R..T~._.~R.T....~.T_T
T~.~+_.R....._..*_._..+....._T
Tx.~......*...+..+...__.~*.T.T
T.*......._~...R.......~.T..xT
T.~~_.+....~+....*.x....RR*..T
T~..x.*._...+.+_.._x..*...~.+T
T+....R.~..~.*.x.RTx.*...x~~RT
TT.R~.R.*..+_..*....~.......*T
T.x~._T+T..~..x....*+*..TT.T*T
T~._.Tx....~......R.R...~....T
T+*+...*~R_R...T.~.*.x...*...T
T...R.x..TT._...~....**...._.T
T......*R.*_.....*x~..._..+..T
T~.....xx.++...T.TR.~x...~._.T
T..*+...xR.._.~~....*...x._..T
TTTTTTTTTTTTTTTTTTTTTTTTTTTTTT