30 30
TTTTTTTTTTTTTTTTTTTTTTTTTTTTTT
T+.TR........**R.*........+._T
T._R..T*.+...+_.....x_.....*_T
T.x~..T+....*.T.+......_.~R_.T
TR*x..R...R...T...~.T.~.x.R.~T
TR....T.~*......x..RR+.+..R_.T
T...~T_..x+*.+.+.*.R_*.x_R.+.T
T.R_+.~T~T.R..++x.TT.R~..*...T
T.++T._+.....*x_._._......+x.T
T...+.._._*...+++..+xR+~R+.T.T
T..*.....~...~.T...x..T._....T
TT~xR......+.*._._~x...T+....T
T..T....~...~.x.._..RT__..x..T
T.x...R*...++_T_.x_..~.R~...*T
T._._..TRT.*Rx._....x.~..+..*T
T..._~.*.R...+R_.....x_...T_+T
T...~R.R.~*+.....R.._+.T..._.T
TR....*.*..+T.......R.._.....T
Tx.....~......+x*__TR.+.T.x..T
T.x.....TL+.TT.+*......+.x.+.T
Tx_.._+.....x.x.x..+.~_x.~+_.T
T...*._..._T.R_.*T.*.......T.T
T.R....T.R.+T.T._.....*R.....T
T..*..._.R._.*x+T..._T..+.~..T
T......*T._....x..._...++.~..T
T...*+x._.Rx.*...+....Rx....TT
T...~.R...R.*T..xxT.T.x...R+.T
T....*..+.._.....~~..~...T...T
T..~R.+T*~....R..T.*RR.._...*T
TTTTTTTTTTTTTTTTTTTTTTTTTTTTTT