30 30
TTTTTTTTTTTTTTTTTTTTTTTTTTTTTT
T~.RRTxR.~.~.+.._.x.+T.~.x.._T
Tx*.+..~._.x.Tx.T.T.TT~*.*x..T
T_._..+.._...T_..*...xTRT_x_.T
T~...T.*.~_~~+T.R....~TRTTR+.T
Tx.x+.R+*._.+.x+._T~R...T.~.TT
T.~.x....~...RR~TT.....~_R...T
T.....+.....x.........+R.T.R.T
T.__~T.+......*...x..T...*...T
TR.x+.TR+....+..T.T...x.._**.T
T.~_..~.x_...+..T~..T.T._.+..T
T*T....T.~.T....R......_x..R.T
T.....+.R..+.RR.......RR.Rx._T
T+..TRx..x....+T*..T*....T~_TT
Tx...x*.R._..._.T.T.xR_...x.+T
T.R~..T...~..*x..._._~.+.R..~T
T.R...RT+.L...T*......x+..*~+T
T.~..x~~.x_.T++R.+.._R...~.~.T
Tx*..Rx~x.*T..*_..+.T.+_....+T
T.x.T..+.......T~_..+...RR..RT
TR~R*_......R_.T....x...+...*T
T....+_...+x+.+T..T..*+._....T
TTx.T.R..R.~R..._..*~*..TRT..T
T_xxx~xT.+..+*...~*R.*...T.x.T
T..~...+T_~.*_.~_..*..+*..._.T
Tx..TxT._+.........~.*.R...**T
T..~._..Tx...._..+T.*..*..~+.T
T.*..R...TT..+~..x*..x..._.~.T
T.+x_+......*.._~T._.+..R..R.T
TTTTTTTTTTTTTTTTTTTTTTTTTTTTTT