30 30
TTTTTTTTTTTTTTTTTTTTTTTTTTTTTT
Tx.~+..Rx.*..x.x*._.~.._*.R..T
T~.x.+...RT..*T..*.+.__R.*..~T
T.*...*...R*+~~x+......T...x.T
T.x....R.._..R.++R....+_.~...T
T.**+.~.T.*.T_*..R..*..x...xxT
T*..T*.~__....*.......+.+..+.T
T..*.~~~.*~.T.+._.._.x..R.x..T
T~T.~R._...*..+T_.T.x+..T._TxT
T.+.R._.......TT.R...+R..~..xT
TT..+..RR_Rx..R~...*..x.+~...T
T_.++.T.x+.T*.R.*_..T...~....T
T........_..T*...+.+...~~....T
T.RT.R+~R.....x..RR..~.x.*.+*T
T..T..~xR.Rx..~._T...R_..~.~*T
T...~..T.*_....T...T...~.R~..T
TTx..x...T..~..T..~++TT._.T.~T
T.*.T....T._.*..*..RT.*.T....T
T*....~T~R+...*R~......*+R.+TT
T..._~Rx.....*...R...*R......T
T...*.~xT+...RxL*...x....x.~+T
T.T_..*...+R.._R+...T.._xR_..T
TRx..T+....R..._R.....x_.~x..T
T+~T.+R..x.x_....x..*......~+T
Tx....x.~...+.R~...x.Rx.*....T
T.x....._Tx..._.__+..*....T.TT
T..Tx~.x....*R~....._.._+.x_.T
T_..x.........~xR..R.**......T
Tx._+.R......_.....*_.+.xR_..T
TTTTTTTTTTTTTTTTTTTTTTTTTTTTTT