20 45
TTTTTTTTTTTTTTTTTTTTTTTTTTTTTTTTTTTTTTTTTTTTT
TT...*.................+..T.........T.......T
T...........+...T....T...T..xRR.+..........-T
T...T.T.~x..-..T......T*R+...........x..R.R.T
T.....T.+..x..x+..+.............*.TT......+.T
T...+.....+...R.T..TR..T...T~..........x....T
T.....-........*.............x.T.....T..x..RT
T.....T.T....T..-...T.R.........TR...R.-....T
TT..*.R.T..T...T.x*.............T......R...-T
T.-R.........*.x......+.T.....R...+x.~......T
T...~....R.....RT...T..............T........T
T..*..R-.T...xT.TTL..R.....TT....R.R..x....TT
T....-..~.....TT~x..........x.TT.x.....T-...T
T...R.....T.T.~..............+..*T.T-~..*R.RT
T.....*T...*.T.....xxT...+...+...Tx.....T.T.T
T~...+.x.....x....T...x..+.R....R..........xT
T...R.....x.-x.......T......x....RT.........T
T........R...T........T.....T.T..TTx....T...T
T.T....T......T.Tx....T......T.R........*..TT
TTTTTTTTTTTTTTTTTTTTTTTTTTTTTTTTTTTTTTTTTTTTT