30 30
TTTTTTTTTTTTTTTTTTTTTTTTTTTTTT
T....~R.+~.+...x.x......._x..T
T..T.R..._...~x.~++.....T..T~T
T.._*.~*R.*.*~+.......TTT.R*.T
TR.T~..T..~_.R.~x...T.+....+.T
T....R..T..+R~.*.T..Rx......_T
T..x...T..~_.*xR._xR~..T...TTT
T.x....R+..+.TT..*..R..T....RT
T....+.....*_..TTx.+...~..~.TT
T....*..~..*T_*_RT.x.*_._.+..T
T.+.+*....+...+~.*.+.R.._.._.T
T.*....__...~.*+.R.*....._..+T
T.xx._..LT._..+..~_...~.xRRx.T
Tx.~......+~._*~~..R_...+....T
T_......x~...x.R.....T.+x~+..T
T...+..T.........x....*xR....T
T+..~~.*.....R....~._.xx...~xT
T....x......x.x_...RTR._.....T
T.xR.._...~+..+T.*T+......~..T
TRx...xT......*+....R*..._+T*T
T...*x.T_..R~.+TT*+..*..T.x..T
T+.T_.R.x*R.R...*..+.+x.~TR~.T
TT...~....R.._._.*x..*.TT*..TT
T.++.~RR_+..T..__..R*...+....T
T..~...x.R.Tx.+......~._.R...T
Tx_~+R*...+x........._+......T
T+.....*~...R....R..~......RTT
T..*+*....RR..~T+.+..x_..R.*.T
T._R+.R+x......~R.__.*.x*T.xxT
TTTTTTTTTTTTTTTTTTTTTTTTTTTTTT