13 20
TTTTT~TTTTTTTTTTTTTT
T....~..~..........T
T....T..T..........T
T....T..T..........T
T....T..T..........T
T....T.xT....+.....T
T.L..T..T..........T
T....T..T..........T
T.*..T..T..........T
T....T..T..........T
T....T..T..........T
T....~..~..........T
TTTTT~TTTTTTTTTTTTTT