14 25
TTTTTTTTTTTTTTTTTTTTTTTTT
T.......................T
T...................R...T
T...................R...T
T...................R...T
TTTTTT..............R...T
T~~~~T..............R...T
T...~TTTTTT..L..........T
T+..~~~~~~..........R...T
T...~TTTTTT.........R...T
T~~~~T..............R...T
T....T..................T
T.+..T..................T
TTTTTTTTTTTTTTTTTTTTTTTTT