17 15
TTTTTTTTTTTTTTT
TL......T...+.T
T.T.T.T.T.T.T.T
T.T...+...T...T
T.T.T.T.T.T.T+T
T.T...........T
T.T.T.T.T.T.TTT
T.T.....T....xT
T.TTT.T.T.T.T.T
T.....T+......T
T.T.T.TTT.TTT+T
T.T...........T
T~~.T.T.T.T.T.T
T+~.T.........T
TTT.T.T.T.T.T.T
T.~.....R...T+T
TTTTTTTTTTTTTTT