10 20
TTTTTTTTTTTTTTTTTTTT
T...T.+.RTx..~.....T
TLT~...~T.T..x._.RxT
TT.~*..TT+...+.~.+.T
T..T.T...+..T..*...T
T..+....~x+xR..R...T
TTT+...Rx.R.._R....T
T......*T..*.x.R..*T
TT.T.T..R~R.TT.R..TT
TTTTTTTTTTTTTTTTTTTT