20 30
TTTTTTTTTTTTTTTTTTTTTTTTTTTTTT
T.R.R........~.x.~T...TTR....T
T...+R.*..*T.T.....R+......+.T
TR.....~.....x..+....+..T....T
TR.T.........x........R..~_R.T
T....T.~.R..TT...........T..TT
T...RTT..+*..*+...++~+..T.TRxT
T.*..T...R........R..........T
T.T...T.*+...~~+T.T.x........T
T_+.L.T*.R..~......T..xTRT.x.T
T...T.*..........._.x...T...TT
T......_.R.T.......TTR_.T...TT
T.T........~..Tx..T~T.R..~..TT
T....._.RT.T..+.xT...Tx.TT...T
T...T...._T~...TTT...R.*.....T
T...~..RRT...T..~.*TT.+..*..TT
TT.....*R..+~..T..~T.....TT..T
T.+....T*T......RT*...T~...T.T
T.T.T....T.R.++.xRT....R..T~.T
TTTTTTTTTTTTTTTTTTTTTTTTTTTTTT