15 15
TTTTTTTTTTTTTTT
TTT.T....+....T
T..T..T.......T
T..T........RTT
T...T..._...T.T
T.LT......_..TT
T..x...T..T..TT
TTT...T....T.TT
TT....T.......T
T+.T.T.T..T...T
T..*..T..T.T_.T
T.T........T.TT
T.x....T.T.T..T
TT.T.T..T...T.T
TTTTTTTTTTTTTTT